   #########################################################################
      #     #  #     #                 #  #  #              #  #        #  #
#  ####  #  #  ####  #  #######  ####  #  #  ####  ##########  #  #  ####  #
#        #  #  #        #  #        #                    #        #  #     #
#  ####  ####  #  ####  #  ####  #  ######################  #######  ####  #
#  #        #  #     #        #  #        #  #        #  #  #     #  #     #
#  ##########  #  ####  ##########  #######  #######  #  #  #  ####  ####  #
#        #     #  #  #  #        #     #     #  #     #     #  #     #     #
#  ####  #  #######  #  #######  #  #  ####  #  #  ####  ####  ####  #  ####
#     #     #  #        #     #     #        #  #  #     #                 #
#  ##########  #############  #  ####  ####  #  #  #  #  #######  ##########
#              #     #  #           #     #     #  #  #  #     #        #  #
####  ####  #######  #  #  ####  #  #  ##########  ##########  #  #######  #
#  #  #  #                 #  #  #  #                 #        #        #  #
#  ####  #  ####  ##########  ##########  #  ####  ####  ####  #######  #  #
#     #     #  #     #  #  #              #     #  #  #  #     #        #  #
#  #######  #  #  #  #  #  #######  #######  #######  ####  ##########  #  #
#              #  #        #     #  #        #  #  #     #           #  #  #
#  #  #  #######  ####  #  #  #  #  ####  #  #  #  ####  #######  #  #  #  #
#  #  #  #           #  #     #  #  #     #     #        #        #        #
################  ############################  #  #######  #  #######  ####
#           #     #              #  #  #  #  #  #           #  #     #     #
####  #  #######  ####  ####  #  #  #  #  #  ####  #######  #  #  #  #  #  #
#     #  #  #           #  #  #  #  #        #     #  #     #     #  #  #  #
#  ####  #  ####  #######  #  #  #  ####  ##########  ####  ####  #######  #
#  #                 #     #  #        #                       #  #        #
#  ####  #  ####  ####  #  ################  #  ####  #######  #  ####  #  #
#     #  #  #     #     #        #  #        #  #  #  #        #     #  #  #
#  #############  #######  #######  ##########  #  #  ####  #######  #  ####
#  #  #        #     #        #        #           #  #     #        #     #
#  #  #  #  ####  ##########  #######  ####  #########################  #  #
#     #  #  #  #  #  #        #        #  #  #  #        #              #  #
#  #######  #  #  #  #######  #######  #  ####  #  #  #######  ##########  #
#  #  #  #        #  #  #        #  #  #  #        #     #           #     #
#  #  #  #  ####  #  #  ####  ####  #  #  ####  #######  ################  #
#     #  #  #     #  #  #        #                 #  #  #        #     #  #
#  #  #  #######  #  #  #  ####  #  ####  ####  #  #  ####  #  #######  #  #
#  #     #                 #     #  #     #  #  #     #     #     #     #  #
#  ################  #  #############  ####  ####  ####  #  #  #  ####  #  #
#     #  #        #  #              #        #  #     #  #  #  #  #        #
#  ####  #######  #  ####  #  ##########  ####  ####  #######  ####  #######
#        #     #  #     #  #                    #     #     #        #     #
#######  #  ####  #  #######  #######  ####  #  #######  ##########  #  #  #
#  #  #           #     #        #        #  #                          #  #
#  #  #  #  ####  #  #  #######  ####  #  #  #  ####  #######  #######  ####
#        #  #  #  #  #        #     #  #  #  #     #     #        #        #
####  ####  #  #######  ##########  ##########  #  ####  ##########  #  ####
#        #        #        #  #        #     #  #  #        #        #     #
#  ######################  #  ####  ####  #  #######  ####  #######  #  ####
#        #                 #              #     #     #     #        #      
#########################################################################   
