   #######
         #
####  ####
#     #  #
#  #  #  #
#  #      
#######   
